17x19
51215141512151215
60006060600060006
60006060600060006
60006060600060006
31415060514151215
00606060606060006
00605121506060006
00606000606060006
51415000606051413
60606000606060600
60605121512150600
60606000600060600
60606000600051415
60606000600060606
51215121512150606
60006000600060606
60006000600060606
60006000600060606
31213121312131213

0 = free space
1 = platform dark
2 = bottom stairs dark
3 = bottom stairs light
4 = stairs with platform dark
5 = stairs with platform light
6 = stairs